288848888882888888888884
311111111113111111111116
311111111113111111111116
311161111113111111111116
311161111113111111111116
311161111113111111111116
311161111113111111111116
599971111113111111111116
311111128888888888888884
311111131111111111111116
311111131111111111111116
311111111111111111111116
311111111111111111111116
311111131111111111111116
311111131111111111111116
311111131111111111111116
311111159999999999999997
311111111111111111111116
599999999999999999999997